SO ./textures/space1.xpm
NO ./textures/space1.xpm
WE ./textures/space1.xpm
EA ./textures/space1.xpm


C   149,146,146
F   149,146,139


1111111111111
1000000000001
100N000000001
1000000000001
1111111111111